                     #         
                     #         
        #########   ######     
               #        #      
    #          #        #      
    #   #      #   #    #   ## 
        #      #####    #    # 
        ##                   # 
              #              # 
              #              # 
        ##                   # 
        #      #####    #    # 
    #   #      #   #    #   ## 
    #          #        #      
               #        #      
        #########   ######     
                     #         
                     #         
