                               
                               
  ###########  ############### 
  #                          # 
  #                          # 
      ###  ###############   # 
      #     #            #   # 
  #   #     #            #   # 
  #   #                  #     
  #   #                  #     
  #   #           #      #   # 
  #   #           #      #   # 
  #   ##############  ####   # 
  #                          # 
  #                          # 
  ######################  #### 
                               
                               
