  #          # 
  #          # 
  #  #    #  # 
     #    #    
     #    #    
     #    #    
  #  #    #  # 
  #          # 
  #          # 
