        #              #       
        #              #       
                               
            ########           
        ####        ####       
      ##  #          #  ##     
    #         ####         #   
         #     ##     #        
   #     #     ##     #     #  
   #     #     ##     #     #  
         #     ##     #        
    #         ####         #   
      ##  #          #  ##     
        ####        ####       
            ########           
                               
        #              #       
        #              #       
