              #  #           # 
              #  #           # 
      #   #   #  #  #####    # 
      #   #         #          
  #####                        
      #               #    #   
      #            ####    #   
###   #               #    ### 
                #          #   
                #          #   
###   #               #    ### 
      #            ####    #   
      #   #           #    #   
  #####   #                    
      #             #          
      #       #  #  #####    # 
              #  #           # 
              #  #           # 
