               
 ##          ##
 #            #
               
   ###    ###  
               
 #            #
 ##          ##
               
