  #           #  #           # 
    #                      #   
      #       #  #       #     
        #              #       
          #   #  #   #         
  #         #      #         # 
              #  #             
                               
      #  #  #      #  #  #     
      #  #  #      #  #  #     
                               
              #  #             
  #         #      #         # 
          #   #  #   #         
        #              #       
      #       #  #       #     
    #                      #   
  #           #  #           # 
