        #              #       
        #              #       
    ##                    ##   
        #    ##  ##    #       
   #    #              #    #  
   #       #        #       #  
           #        #          
              #  #             
          #          #         
          #          #         
              #  #             
           #        #          
   #       #        #       #  
   #    #              #    #  
        #    ##  ##    #       
    ##                    ##   
        #              #       
        #              #       
