#############################  #
             #   #     #       #
             #   #             #
##########   #                 #
########     #         #       #
#            #   #     #  ###  #
#       ##   #   ###  ##    ####
#            #   #     #    #  #
#            #   #          #  #
#                #          #  #
#                #     #       #
#       ##       #     #       #
#         ##   #####  #######  #
########         #      #      #
##########                     #
                               
                 #      #      
################################
