          #      #        #    
       #     #        ##       
        ############  #####  # 
        #   #    #    #      # 
     #      #    #    #      ##
     #      ##       ##  ##    
         #           #         
                #            # 
            #          #       
            #      #   #       
            ###              # 
         #  #        #         
     #      #    ##  ##  ##    
     #           #    #      ##
        #     #  #    #      # 
        ###########  ######  # 
       #  #      #        #    
             #         #       
