      #       #     ############
      #       #     #          
      #  ###  #  #  #          
      #  #    #  #  #  #  ######
  #      #    #  #  #  #       
  #      #    #  #     #       
  #  #####  ###  #     ####### 
  #   #          #  #  #       
  #   #          #  #  #       
  ##  #  ######  #  #  #  ######
  #   #  #       #  #  #  #    
  #   #  #       #  #  #  #    
  #  ##  #  ######  #  #  #  # 
  #      #          #        # 
  #      #          #        # 
  ############################ 
                               
                               
